Json
Array [	[ ArrayT
ArrayT [	Values ]
ArrayT false	Values ]
ArrayT null	Values ]
ArrayT number	Values ]
ArrayT string	Values ]
ArrayT true	Values ]
ArrayT {	Values ]
ArrayT ]	]
Boolean true	true
Boolean false	false
Json {	Object
Json [	Array
Member string	String : Value
Members string	Member MembersT
MembersT ,	, Member MembersT
MembersT }	e
Null null	null
Number number	number
Object {	{ ObjectT
ObjectT string	Members }
ObjectT }	}
String string	string
Value string	String
Value number	Number
Value {	Object
Value [	Array
Value false	Boolean
Value true	Boolean
Value null	Null
Values [	Value ValuesT
Values false	Value ValuesT
Values null	Value ValuesT
Values number	Value ValuesT
Values string	Value ValuesT
Values true	Value ValuesT
Values {	Value ValuesT
ValuesT ,	, Value ValuesT
ValuesT ]	e
